Timestamp: 2025-01-15T11:18:29.557978
Title: 为什么无论我们怎么努力也改变不了现状？ BV1fvCWYEEX1
URL: https://b23.tv/etw8EsC
Status: success
Duration: 5:06

Description:
**Outline:**

1.  **The Illusion of Effort:**
    *   Traditional belief: Effort leads to success and happiness.
    *   Personal experience: Despite efforts, desired outcomes are not achieved.
    *   Observation: Many hardworking individuals (e.g., construction workers) do not achieve their desired lives.

2.  **Debunking the Myth:**
    *   Rejection of common explanations: The problem is not solely due to societal injustice, inequality, or lack of education.
    *   The importance of direction:  Effort without the right direction leads to negative consequences.
    *   The failure of classic sayings: "Persistence is victory" is deemed a false promise without the proper direction.

3.  **The Real Key to Success:**
    *   Self-awareness and goal clarity: Understanding one's passions, talents, and core values are crucial.
    *   Leveraging strengths:  Focusing on personal strengths to outcompete others.
    *   Strategic planning: Developing well-thought-out short, medium, and long-term personal growth plans.
    *   Utilizing effective thinking strategies: Employing design thinking, systems thinking, logical thinking, and critical thinking.
    *   The value of effort and persistence: These are effective only when combined with the correct direction and self-knowledge.

4.  **Two Types of Life:**
    *   Current state: A mundane, unsatisfying life (referred to as "dog-like").
    *   Second life: A transformation initiated by dissatisfaction and intentional change.
    *   Author's transformation: Leaving a stable job for a more fulfilling, nomadic career path.

5.  **Concluding Thoughts:**
    *   Call to action: Engage in discussion and feedback.
    *   Stoic inspiration: If you don’t know your destination, no wind will be beneficial.

**Core Point:** The core point is that achieving success and fulfillment requires a clear understanding of one's direction, passions, and strengths, not just relentless effort and persistence.

**Fundamental Point:**  The fundamental point is that directed effort is essential;  unfocused or misdirected effort is futile and can lead to undesirable outcomes.

**Overarching Framework:** The overarching framework is a re-evaluation of the conventional wisdom of "hard work equals success," positing that self-awareness, strategic planning, and directed action are fundamentally important for achieving one's goals and leading a fulfilling life.

<Mermaid_Diagram>
graph LR
    A[Traditional Belief: Effort = Success] --> B(Personal Experience: Effort ≠ Desired Outcomes);
    B --> C[Observation: Hard Work Does Not Guarantee Success];
    C --> D[Rejection of Common Explanations (Inequality, etc.)];
    D --> E[The Importance of Direction];
    E --> F["Persistence is Victory" is False without Direction];
    F --> G[Key to Success: Self-Awareness & Goal Clarity];
    G --> H[Leveraging Strengths & Outcompeting Others];
    H --> I[Strategic Personal Growth Planning];
    I --> J[Employing Effective Thinking Strategies];
    J --> K{Effort & Persistence + Direction = Success};
        K --> L[Current "Dog-like" Life];
    K --> M[Second Life: Transformation through Change];
    M --> N[Author's Transformation to Nomadic Career];
     N --> O[Stoic Wisdom: Know Your Destination];
     O --> P[Call to Action: Discussion & Feedback];
     style A fill:#f9f,stroke:#333,stroke-width:2px
    style G fill:#ccf,stroke:#333,stroke-width:2px
    style K fill:#aaf,stroke:#333,stroke-width:2px
     style N fill:#bbf,stroke:#333,stroke-width:2px
</Mermaid_Diagram>


Content:
为什么无论我们怎么努力,也改变不了现状?从小到大,我们大家都被灌输了一种理念努力就能改变自己的命运努力就能实现积极的跨越努力就能获得人生的幸福而使我就幻想,只要我努力学习,就会有美好的明天当他抽校园,只要我努力工作,就会走上人生天风引起白富美,但是人之中言,却从未实现我理想中的生活所有的一切都围绕著一个自难反观现状,水又不难能支撑中言男人的几大法宝,无非是外卖小哥往约车快递代价,辛苦外加内卷为了生存,我们都在不同的点上努力著奋斗著最重要的是为了够活著,这是我们想要的吗?这就是我们努力的结果吗?这时候,我不仅想到了一句经典名言,坚持就是胜利但我用了几十年的青春,明白了一个显为人之的道理这就是一个世纪委命题你们不信,我给你们一点例子,请看街边转角出的小饭,5夜的还未工人,灰汉如雨的建筑工人,请问,他们不够努力吗?他们不够坚持吗?但是,他们过上了他们想要的生活吗?没有,绝对没有他们还在苦苦为了生存而征窄称起那个属于他们的小家那么,造成这一切的原因是什么呢?是社会的不公吗?是贫富的差距吗?是阶级的差异吗?是否受过教育吗?都不是这个时候,我们需要马斯克用于SpaceX的改造技术第一性原理让我们回到事物的起点努力和坚持,为什么不能取得成功?为什么这两句经典名言,会变成世纪最大的谎言?核心在于大家忽视了他们的前提条件方向一个正确的方向举一个简单的例子,如果前面是一个巨坑是一个悬崖我们努力,我们坚持下去的结果不堪设想作为一您专业的人生规划师,职业规划师,我未无数的人无数的企业规划了人生方向,职业方向发展方向,根据我十多年的从业经验来看一个人一个企业不能取得理想中的成功关键问题,不在于他们是否努力如何坚持?核心在于?他们是否真正了解自己的理想目标,特长核心去所在?正如乔不思说的,其他人认为我每天工作十六个小时这是不现实的,但是我想告诉他们那是我的理想核心去所在,我正追寻我的梦想他们足以支持我走下去这句话,就从一个侧面告诉了我们只有找到自己真正的理想性去特长所在?用我们自己的长处,和别人的短处拼服役良好的长期中期短期个人成长计划善用设计思维、系统思维、逻辑思维、批判思维等只有这个时候,努力和坚持才变得有意义才会大方一彩,才会取得巨大的成功纵观每一个伟大的人,每一个伟大的企业,盖墨如此显显的看,我们每一个人的人生有数万一种可能但身层看,我认为,每个人上至特朗普下至如你我的无名小被,都只有两种人生一种是我们现在的狗杰人生只有当我们不满现状想要改变,做出改变于是我们变有了属于自己的第二种人生作为一名专业从业者为什么我没有过上想要的生活仲然有不错的待遇,相对稳定的工作和生活但这一切都不是我想要的所以,近期我吵了老板的犹豫力制作一个无忧无虑的自由工作者突不远行,过著也意江湖的人生顺便能力所能及帮助更多的人哪怕居无定所、封餐路速,也是一种平淡的幸福欢迎大家在评论区留言讨论,或者私信我无论是批评指正看讨,我们大家都因加强交流最后,用斯多格主义中,我很喜欢的一句话作为结尾如果一个人不知道他要行情到哪个港口任何风都无法成为他的助力以上就是本次分享的内容,未完,下次见
